# "allocation flags" are set when the corresponding datum is imputed
#Housing records:

RT: Record type (H or P)
SERIALNO: Housing unit or Person serial number
DIVISION: Division code based on 2010 Census definitions Division code based on 2020 Census definitions
PUMA: Public use microdata area code (PUMA) based on 2020 Census definition (areas with population of 100,000 or more, use with ST for unique code)
REGION: Region code based on 2020 Census definitions
ST: State Code based on 2020 Census definitions
ADJHSG: Adjustment factor for housing dollar amounts (6 implied decimal places)
ADJINC: Adjustment factor for income and earnings dollar amounts (6 implied decimal places)
WGTP: Housing Unit Weight
NP: Number of persons in this household
TYPEHUGQ: Type of unit
HOUSING: ACCESSINET Character 1
ACCESSINET: Access to the Internet
ACR: Lot size
AGS: Sales of Agriculture Products (yearly sales, no adjustment factor is applied)
BATH: Bathtub or shower
BDSP: Number of bedrooms
BLD: Units in structure
BROADBND: Cellular data plan for a smartphone or other mobile device
COMPOTHX: Other computer equipment
CONP: Condominium fee (monthly amount, use ADJHSG to adjust CONP to constant dollars)
DIALUP: Dial-up service
ELEFP: Electricity cost flag variable
ELEP: Electricity cost (monthly cost, use ADJHSG to adjust ELEP to constant dollars)
FS: Yearly food stamp/Supplemental Nutrition Assistance Program (SNAP) recipiency
FULFP: Fuel cost flag variable
FULP: Fuel cost (yearly cost for fuels other than gas and electricity, use ADJHSG to adjust FULP to constant dollars)
GASFP: Gas cost flag variable
GASP: Gas cost (monthly cost, use ADJHSG to adjust GASP to constant dollars)
HFL: House heating fuel
HISPEED: Broadband (high speed) Internet service such as cable, fiber optic, or DSL service
HOTWAT: Water heater (Puerto Rico only)
INSP: Fire/hazard/flood insurance (yearly amount, use ADJHSG to adjust INSP to constant dollars)
LAPTOP: Laptop or desktop
MHP: Mobile home costs (yearly amount, use ADJHSG to adjust MHP to constant dollars)
MRGI: First mortgage payment includes fire/hazard/flood insurance
MRGP: First mortgage payment (monthly amount, use ADJHSG to adjust MRGP to constant dollars)
MRGT: First mortgage payment includes real estate taxes
MRGX: First mortgage status
OTHSVCEX: Other Internet service
REFR: Refrigerator
RMSP: Number of rooms
RNTM: Meals included in rent
RNTP: Monthly rent (use ADJHSG to adjust RNTP to constant dollars)
RWAT: Hot and cold running water
RWATPR: Running water
SATELLITE: Satellite Internet service
SINK: Sink with a faucet
SMARTPHONE: Smartphone
SMP: Total payment on all second and junior mortgages and home equity loans (monthly amount, use ADJHSG to adjust SMP to constant dollars)
STOV: Stove or range
TABLET: Tablet or other portable wireless computer
TEL: Telephone service
TEN: Tenure
VACDUR: Vacancy duration
VACOTH: Other vacancy status
VACS: Vacancy status
VALP: Property value
VEH: Vehicles (1 ton or less) available
WATFP: Water cost flag variable
WATP: Water cost (yearly cost, use ADJHSG to adjust WATP to constant dollars)
YRBLT: When structure first built
HOUSING: CPLT Character 1
CPLT: Couple Type
FINCP: Family income (past 12 months, use ADJINC to adjust FINCP to constant dollars)
FPARC: Family presence and age of related children
GRNTP: Gross rent (monthly amount, use ADJHSG to adjust GRNTP to constant dollars)
GRPIP: Gross rent as a percentage of household income past 12 months
HHL: Household language
HHLANP: Detailed household language
HHLDRAGEP: Age of the householder
HHLDRHISP: Recoded detailed Hispanic origin of the householder
HHLDRRAC1P: Recoded detailed race code of the householder
HHT: Household/family type
HHT2: Household/family type (includes cohabiting)
HINCP: Household income (past 12 months, use ADJINC to adjust HINCP to constant dollars)
HUGCL: Household with grandparent living with grandchildren
HUPAC: HH presence and age of children
HH: b .N/A (GQ/vacant)
HUPAOC: HH presence and age of own children
HH: b .N/A (GQ/vacant)
HUPARC: HH presence and age of related children
HH: b .N/A (GQ/vacant)
KIT: Complete kitchen facilities
LNGI: Limited English speaking household
MULTG: Multigenerational household
MV: When moved into this house or apartment
NOC: Number of own children in household (unweighted)
NPF: Number of persons in family (unweighted)
NPP: Grandparent headed household with no parent present
NR: Presence of nonrelative in household
NRC: Number of related children in household (unweighted)
OCPIP: Selected monthly owner costs as a percentage of household income during the past 12 months
PARTNER: Unmarried partner household
PLM: Complete plumbing facilities
PLMPRP: Complete plumbing facilities for Puerto Rico
PSF: Presence of subfamilies in household
R18: Presence of persons under 18 years in household (unweighted)
R60: Presence of persons 60 years and over in household (unweighted)
R65: Presence of persons 65 years and over in household (unweighted)
RESMODE: Response mode
SMOCP: Selected monthly owner costs (use ADJHSG to adjust SMOCP to constant dollars)
SMX: Second or junior mortgage or home equity loan status
SRNT: Specified rental unit
SVAL: Specified owner unit
TAXAMT: Property taxes (yearly real estate taxes)
WIF: Workers in family during the past 12 months
WKEXREL: Work experience of householder and spouse
WORKSTAT: Work status of householder or spouse in family households
HOUSING: FACCESSP Character 1
FACCESSP: Access to the Internet allocation flag
FACRP: Lot size allocation flag
FAGSP: Sales of Agricultural Products allocation flag
FBATHP: Bathtub or shower allocation flag
FBDSP: Number of bedrooms allocation flag
FBLDP: Units in structure allocation flag
FBROADBNDP: Cellular data plan for a smartphone or other mobile device allocation flag
FCOMPOTHXP: Other computer equipment allocation flag
FCONP: Condominium fee (monthly amount) allocation flag
FDIALUPP: Dial-up service allocation flag
FELEP: Electricity cost (monthly cost) allocation flag
FFINCP: Family income (past 12 months) allocation flag
FFSP: Yearly food stamp/Supplemental Nutrition Assistance Program (SNAP) recipiency allocation flag
FFULP: Fuel cost (yearly cost for fuels other than gas and electricity) allocation flag
FGASP: Gas cost (monthly cost) allocation flag
FGRNTP: Gross rent (monthly amount) allocation flag
FHFLP: House heating fuel allocation flag
FHINCP: Household income (past 12 months) allocation flag
FHISPEEDP: Broadband (high speed) Internet service such as cable, fiber optic, or DSL service allocation flag
FHOTWATP: Water heater allocation flag (Puerto Rico only)
FINSP: Fire, hazard, flood insurance (yearly amount) allocation flag
FKITP: Complete kitchen facilities allocation flag
FLAPTOPP: Laptop or desktop allocation flag
FMHP: Mobile home costs (yearly amount) allocation flag
FMRGIP: First mortgage payment includes fire, hazard, flood insurance allocation flag
FMRGP: First mortgage payment (monthly amount) allocation flag
FMRGTP: First mortgage payment includes real estate taxes allocation flag
FMRGXP: First mortgage status allocation flag
FMVP: When moved into this house or apartment allocation flag
FOTHSVCEXP: Other Internet service allocation flag
FPLMP: Complete plumbing facilities allocation flag
FPLMPRP: Complete plumbing facilities allocation flag for Puerto Rico
FREFRP: Refrigerator allocation flag
FRMSP: Number of rooms allocation flag
FRNTMP: Meals included in rent allocation flag
FRNTP: Monthly rent allocation flag
FRWATP: Hot and cold running water allocation flag
FRWATPRP: Running water allocation flag for Puerto Rico
FSATELLITEP: Satellite Internet service allocation flag
FSINKP: Sink with a faucet allocation flag
FSMARTPHONP: Smartphone allocation flag
FSMOCP: Selected monthly owner cost allocation flag
FSMP: Total payment on second and junior mortgages and home equity loans (monthly amount) allocation flag
FSMXHP: Home equity loan status allocation flag
FSMXSP: Second mortgage status allocation flag
FSTOVP: Stove or range allocation flag
FTABLETP: Tablet or other portable wireless computer allocation flag
FTAXP: Property taxes (yearly amount) allocation flag
FTELP: Telephone service allocation flag
FTENP: Tenure allocation flag
FVACDURP: Vacancy duration allocation flag
FVACOTHP: Other vacancy allocation flag
FVACSP: Vacancy status allocation flag
FVALP: Property value allocation flag
FVEHP: Vehicles available allocation flag
FWATP: Water cost (yearly cost) allocation flag
FYRBLTP: When structure first built allocation flag

#Person records:

DIVISION: Division code based on 2010 Census definitions Division code based on 2020 Census definitions
SPORDER: Person number
PUMA: Public use microdata area code (PUMA) based on 2020 Census definition (areas with population of 100,000 or more, use with ST for unique code)
REGION: Region code based on 2020 Census definitions
ST: State Code based on 2020 Census definitions
ADJINC: Adjustment factor for income and earnings dollar amounts (6 implied decimal places)
PWGTP: Person's weight
PERSON: AGEP Numeric 2
AGEP: Age
CIT: Citizenship status
CITWP: Year of naturalization write-in
COW: Class of worker
DDRS: Self-care difficulty
DEAR: Hearing difficulty
DEYE: Vision difficulty
DOUT: Independent living difficulty
DPHY: Ambulatory difficulty
DRAT: Veteran service-connected disability rating (percentage)
DRATX: Veteran service-connected disability rating (checkbox)
DREM: Cognitive difficulty
ENG: Ability to speak English
FER: Gave birth to child within the past 12 months
GCL: Grandparents living with grandchildren
GCM: Length of time responsible for grandchildren
GCR: Grandparents responsible for grandchildren
HIMRKS: Subsidized Marketplace Coverage
HINS1: Insurance through a current or former employer or union
HINS2: Insurance purchased directly from an insurance company
HINS3: Medicare, for people 65 and older, or people with certain disabilities
HINS4: Medicaid, Medical Assistance, or any kind of government-assistance plan for those with low incomes or a disability
HINS5: TRICARE or other military health care
HINS6: VA (enrolled for VA health care)
HINS7: Indian Health Service
INTP: Interest, dividends, and net rental income past 12 months (use ADJINC to adjust to constant dollars)
JWMNP: Travel time to work
JWRIP: Vehicle occupancy
JWTRNS: Means of transportation to work
LANX: Language other than English spoken at home
MAR: Marital status
MARHD: Divorced in the past 12 months
MARHM: Married in the past 12 months
MARHT: Number of times married
MARHW: Widowed in the past 12 months
MARHYP: Year last married
MIG: Mobility status (lived here 1 year ago)
MIL: Military service
MLPA: Served September 2001 or later
MLPB: Served August 1990 - August 2001 (including Persian Gulf War)
MLPCD: Served May 1975 - July 1990
MLPE: Served Vietnam era (August 1964 - April 1975)
MLPFG: Served February 1955 - July 1964
MLPH: Served Korean War (July 1950 - January 1955)
MLPIK: Peacetime service before July 1950
MLPJ: Served World War II (December 1941 - December 1946)
NWAB: Temporary absence from work (UNEDITED - See 'Employment Status Recode' (ESR))
NWAV: Available for work (UNEDITED - See 'Employment Status Recode' (ESR))
NWLA: On layoff from work (UNEDITED - See 'Employment Status Recode' (ESR))
NWLK: Looking for work (UNEDITED - See 'Employment Status Recode' (ESR))
NWRE: Informed of recall (UNEDITED - See 'Employment Status Recode' (ESR))
OIP: All other income past 12 months (use ADJINC to adjust to constant dollars)
PAP: Public assistance income past 12 months (use ADJINC to adjust to constant dollars)
RELSHIPP: Relationship
RETP: Retirement income past 12 months (use ADJINC to adjust to constant dollars)
SCH: School enrollment
SCHG: Grade level attending
SCHL: Educational attainment
SEMP: Self-employment income past 12 months (use ADJINC to adjust SEMP to constant dollars)
SEX: Sex
SSIP: Supplementary Security Income past 12 months (use ADJINC to adjust SSIP to constant dollars)
SSP: Social Security income past 12 months (use ADJINC to adjust SSP to constant dollars)
WAGP: Wages or salary income past 12 months (use ADJINC to adjust WAGP to constant dollars)
WKHP: Usual hours worked per week past 12 months
WKL: When last worked
WKWN: Weeks worked during past 12 months
WRK: Worked last week
YOEP: Year of entry
PERSON: ANC Character 1
ANC: Ancestry recode
ANC1P: Recoded Detailed Ancestry - first entry
ANC2P: Recoded Detailed Ancestry - second entry
DECADE: Decade of entry
DIS: Disability recode
DRIVESP: Number of vehicles calculated from JWRI
ESP: Employment status of parents
ESR: Employment status recode
FOD1P: Recoded field of degree - first entry
FOD2P: Recoded field of degree - second entry
HICOV: Health insurance coverage recode
HISP: Recoded detailed Hispanic origin
INDP: Industry recode for 2018 and later based on 2017 IND codes
JWAP: Time of arrival at work - hour and minute
JWDP: Time of departure for work - hour and minute
LANP: Language spoken at home
MIGPUMA: Migration PUMA based on 2020 Census definition
MIGSP: Migration recode - State or foreign country code
MSP: Married, spouse present/spouse absent
NAICSP: North American Industry Classification System (NAICS) recode for 2018 and later based on 2017 NAICS codes
NATIVITY: Nativity
NOP: Nativity of parent
OC: Own child
OCCP: Occupation recode for 2018 and later based on 2018 OCC codes
PAOC: Presence and age of own children
PERNP: Total person's earnings (use ADJINC to adjust to constant dollars)
PINCP: Total person's income (use ADJINC to adjust to constant dollars)
POBP: Place of birth (Recode)
POVPIP: Income-to-poverty ratio recode
POWPUMA: Place of work PUMA based on 2020 Census definition
POWSP: Place of work - State or foreign country recode
PRIVCOV: Private health insurance coverage recode
PUBCOV: Public health coverage recode
QTRBIR: Quarter of birth
RAC1P: Recoded detailed race code
RAC2P: Recoded detailed race code
RAC3P: Recoded detailed race code
RACAIAN: American Indian and Alaska Native recode (American Indian and Alaska Native alone or in combination with one or more other races)
RACASN: Asian recode (Asian alone or in combination with one or more other races)
RACBLK: Black or African American recode (Black alone or in combination with one or more other races)
RACNH: Native Hawaiian recode (Native Hawaiian alone or in combination with one or more other races)
RACNUM: Number of major race groups represented
RACPI: Other Pacific Islander recode (Other Pacific Islander alone or in combination with one or more other races)
RACSOR: Some other race recode (Some other race alone or in combination with one or more other races)
RACWHT: White recode (White alone or in combination with one or more other races)
RC: Related child
SCIENGP: Field of Degree Science and Engineering Flag - NSF Definition
SCIENGRLP: Field of Degree Science and Engineering Related Flag - NSF Definition
SFN: Subfamily number
SFR: Subfamily relationship
SOCP: Standard Occupational Classification (SOC) codes for 2018 and later based on 2018 SOC codes
VPS: Veteran period of service
WAOB: World area of birth
PERSON: FAGEP Character 1
FAGEP: Age allocation flag
FANCP: Ancestry allocation flag
FCITP: Citizenship allocation flag
FCITWP: Year of naturalization write-in allocation flag
FCOWP: Class of worker allocation flag
FDDRSP: Self-care difficulty allocation flag
FDEARP: Hearing difficulty allocation flag
FDEYEP: Vision difficulty allocation flag
FDISP: Disability recode allocation flag
FDOUTP: Independent living difficulty allocation flag
FDPHYP: Ambulatory difficulty allocation flag
FDRATP: Disability rating percentage allocation flag
FDRATXP: Disability rating checkbox allocation flag
FDREMP: Cognitive difficulty allocation flag
FENGP: Ability to speak English allocation flag
FESRP: Employment status recode allocation flag
FFERP: Gave birth to child within the past 12 months allocation flag
FFODP: Field of Degree allocation flag
FGCLP: Grandparents living with grandchildren allocation flag
FGCMP: Length of time responsible for grandchildren allocation flag
FGCRP: Grandparents responsible for grandchildren allocation flag
FHICOVP: Health insurance coverage recode allocation flag
FHIMRKSP: Subsidized Marketplace Coverage allocation flag
FHINS1P: Insurance through a current or former employer or union allocation flag
FHINS2P: Insurance purchased directly from an insurance company allocation flag
FHINS3C: Medicare coverage given through the eligibility coverage edit
FHINS3P: Medicare, for people 65 or older, or people with certain disabilities allocation flag
FHINS4C: Medicaid coverage given through the eligibility coverage edit
FHINS4P: Medicaid, medical assistance, or any kind of government-assistance plan for people with low incomes or a disability allocation flag
FHINS5C: TRICARE coverage given through the eligibility coverage edit
TRICARE: b .Does not have TRICARE coverage (HINS5=2)
FHINS5P: TRICARE or other military health care allocation flag
TRICARE: 0 .No
FHINS6P: VA (enrolled for VA health care) allocation flag
VA: 0 .No
FHINS7P: Indian health service allocation flag
FHISP: Detailed Hispanic origin allocation flag
FINDP: Industry allocation flag
FINTP: Interest, dividend, and net rental income allocation flag
FJWDP: Time of departure to work allocation flag
FJWMNP: Travel time to work allocation flag
FJWRIP: Vehicle occupancy allocation flag
FJWTRNSP: Means of transportation to work allocation flag
FLANP: Language spoken at home allocation flag
FLANXP: Language other than English allocation flag
FMARP: Marital status allocation flag
FMARHDP: Divorced in the past 12 months allocation flag
FMARHMP: Married in the past 12 months allocation flag
FMARHTP: Times married allocation flag
FMARHWP: Widowed in the past 12 months allocation flag
FMARHYP: Year last married allocation flag
FMIGP: Mobility status allocation flag
FMIGSP: Migration state and foreign country allocation flag
FMILPP: Military periods of service allocation flag
FMILSP: Military service allocation flag
FOCCP: Occupation allocation flag
FOIP: All other income allocation flag
FPAP: Public assistance income allocation flag
FPERNP: Total person's earnings allocation flag
FPINCP: Total person's income allocation flag
FPOBP: Place of birth allocation flag
FPOWSP: Place of work state allocation flag
FPRIVCOVP: Private health insurance coverage recode allocation flag
FPUBCOVP: Public health coverage recode allocation flag
FRACP: Detailed race allocation flag
FRELSHIPP: Relationship allocation flag
FRETP: Retirement income allocation flag
FSCHGP: Grade attending allocation flag
FSCHLP: Highest education allocation flag
FSCHP: School enrollment allocation flag
FSEMP: Self-employment income allocation flag
FSEXP: Sex allocation flag
FSSIP: Supplementary Security Income allocation flag
FSSP: Social Security income allocation flag
FWAGP: Wages and salary income allocation flag
FWKHP: Usual hours worked per week past 12 months allocation flag
FWKLP: Last worked allocation flag
FWKWNP: Weeks worked past 12 months allocation flag
FWRKP: Worked last week allocation flag
FYOEP: Year of entry allocation flag
